11111111111111111
1PE011000C1000001
11000101111100001
111000000000000C1
11111111111111111