1111111111111111111111111100
1E00000000000000000000000110
1111111111C11101111111111111
110000C001010100011000000C11
1P00011100000111010011111011
1000000000000000000000000001
1000011100001111110111100001
1100111111011C01100111001001
1110000000000000000000011001
1111111111111111111111111111