11111111111111111111111111111110000
11E000C00000001110000000000C0011000
11111101111000001111000111001011000
11100100001111001100000000111011111
11000000011100C00100111100000000C01
11000000000000000000000000000111101
11110000011110001100111011110011101
11P00000010011011100C10011100011101
111100100100110000000000100000000C1
11111111110011111111111111111111111