111111111111111111
11C01110010P000111
100110110101000111
100000000000000011
111111011110111111
110000000000000E11
111111111111111111